4
#rooms:
##start
0   0   0   1
1   0   1   2
2   0   2   3
3   1   0   2
4   1   1   3
5   1   2   4
6   2   0   3
7   2   1   2
##end
8   2   2   1
#links
0-1
1-2
4-7
7-8
6-7
4-5
1-4
2-5
3-6
0-3
3-4
5-8
